12,12
G G G G G G G G G G G G
G . . . . . . . . . . G
G . . R . . . G . . . G
G . R R . . G . G G . G
G . . . . G G . . G . G
G . . . . G G . G G . ?
? . . . . . . . . . . .
. . . . . . . . . . . .
. . . P . . . . . . . ?
? . . . . . . . . . . G
G . . . . . . @ . . . G
G G ? . . ? G G G G G G