12,12
G G G G G G G G G G G G
G . . . . . . . . . . G
G . . . . . . B . . . G
G . R @d@d. B . B . . G
G . . R R B . . @cB . G
G . . . . B . . B B . ?
? . . . . . . . . . . .
. . . . . . . . . . . .
. . . P . . . . . . . ?
? . . . . . . . . . . G
G . . . . . . @p. . . G
G G ? . . ? G G G G G G