12,12
G G G G G G G G G G G G
G . . . . . . . . . . G
G . . . . . . B . . . G
G . R . . . B . B . . G
G . . R R B . . . B . G
G . . . . B . . B B . ?
? . . . . . . . . . . .
. . . . . . . . . . . .
. . . P . . . . . . . ?
? . . . . . . . . . . G
G . . . . . . @ . . . G
G G ? . . ? G G G G G G