50,50
0 0 0 0 0 0 0 0 0 0 0 0 0 0 0 0 0 1 1 1 1 1 1 1 1 1 1 1 1 1 1 1 1 1 1 1 1 1 1 1 1 1 1 1 1 1 1 1 1 1
0 . . . . . . . . . . . . . . . . . . . . . . . 1 . . . . . 1 . . . . . . . 1 . . . . . . . . . . 1
0 @d0 . . 0 0 0 0 0 0 0 0 0 0 0 0 1 1 1 1 1 1 . 1 1 1 1 1 1 1 . . . @c. . . 1 1 1 1 1 1 1 1 1 1 1 1
0 0 0 . . . . . . . . . . . . . 0 . . . . . 1 . . . . . . . . . . . . . . . . . . . . . . . . 1 . 1
0 . . . 0 0 0 0 0 0 0 0 0 0 0 . 0 1 1 1 1 1 1 1 1 1 1 1 1 1 1 1 1 1 1 . 1 1 1 1 1 1 1 1 1 1 . 1 . 1
0 . 0 . 0 . . . . . . . . . 0 0 0 . . . . . . . . . . . . . 1 . . . 1 . . . 1 . . . 1 . . 1 1 1 . 1
0 . 0 . 0 . 1 1 1 1 1 1 1 1 1 1 1 1 1 1 1 1 1 1 1 1 1 1 1 1 1 1 . 1 1 1 . 1 1 1 . 1 1 1 . 1 . 1 . 1
0 . 0 . 0 . 1 . . . . . . . . . . . 1 . . . . . . . . . . . . . . . . . . . . . . 1 . 1 . 1 . 1 . 1
0 . 0 . 0 . 1 . 1 1 1 1 1 1 1 1 . 1 1 . 1 1 1 1 1 1 1 1 1 1 1 1 1 1 1 1 1 1 1 1 1 1 . 1 . 1 . 1 . 1
0 . 0 . 0 . 1 1 1 . . . . . . 1 . 1 . . . . . . . . . . . . . . . . . . . . . . . 1 . 1 . 1 . 1 . 1
0 . 0 . 0 . 1 . 1 . 1 1 1 1 1 1 . 1 1 1 1 1 1 1 1 1 1 1 1 1 1 1 1 1 1 1 1 1 1 1 . 1 . 1 . 1 . 1 . 1
0 . 0 . 0 . 1 . 1 . . . . . . 1 . 1 . . . . . . . . . . . . . . . . . . . . . . . 1 . 1 . 1 . 1 . 1
0 . 0 . 0 . 1 . 1 . 1 . 1 1 . 1 . 1 1 1 1 1 1 1 1 1 1 1 1 1 1 1 1 1 1 1 1 1 1 1 . 1 . 1 . 1 . 1 . 1
0 . 0 . 0 . 1 . 1 1 1 . 1 . . 1 . 1 . . . . . . . . . . . . . . . . . . . 1 . . . 1 . 1 . 1 . 1 . 1
0 . 0 . 0 . 1 . 1 . 1 . 1 . 1 1 . 1 1 1 1 1 1 1 1 1 1 1 1 1 1 1 1 1 1 1 . 1 . 1 1 1 . 1 . 1 . 1 . 1
0 . 0 . 0 . 1 . 1 . 1 . 1 . 1 . . . . . . . . . . . . . . . . . . . . . . 1 . . . 1 . 1 . 1 . 1 . 1
0 . 0 . 0 . 1 . 1 . 1 . 1 . 1 . 1 1 1 1 1 1 1 1 1 1 1 1 1 1 1 1 1 1 . 1 . 1 1 1 . 1 . 1 . 1 . 1 . 1
0 . 0 . 0 . 1 . 1 . 1 . 1 . 1 . 1 . . . . . . . . . . . . . . . . 1 . 1 . 1 . . . 1 . 1 . 1 . 1 . 1
0 . 0 . 0 . 1 . 1 . 1 . 1 . 1 . 1 . 1 1 1 1 1 1 1 1 1 1 1 1 1 1 . 1 . 1 . 1 . 1 1 1 . 1 . 1 . 1 . 1
0 . 0 . 0 . 1 . 1 . 1 . 1 . 1 . 1 . 1 . . . . . . . . . . . . 1 . 1 . 1 . 1 . . . 1 . 1 . 1 . 1 . 1
0 . 0 . 0 . 1 . 1 . 1 . 1 . 1 . 1 . 1 . 1 1 1 1 1 1 1 1 1 1 . 1 . 1 . 1 . 1 1 1 . 1 . 1 . 1 . 1 . 1
0 . 0 . 0 . 1 . 1 . 1 . 1 . 1 . 1 . 1 . 1 . . . . . 1 . . 1 . 1 . 1 . 1 . 1 . . . 1 . 1 . 1 . 1 . 1
0 . 0 . 0 . 1 . 1 . 1 . 1 . 1 . 1 . 1 . 1 . 1 . 1 1 1 1 . 1 . 1 . 1 . 1 . 1 . 1 1 1 . 1 . 1 . 1 . 1
0 . 0 . 0 . 1 . 1 . 1 . 1 . 1 . 1 . 1 . 1 . 1 . . . . 1 . 1 . 1 . 1 . 1 . 1 . . . 1 . 1 . 1 . 1 . 1
0 . 0 . 0 . 1 . 1 . 1 . 1 . 1 . 1 . 1 . 1 . 1 . . . . 1 . 1 . 1 . 1 . 1 1 1 1 1 . 1 . 1 . 1 . 1 . 1
0 . 0 . 0 . 1 . 1 . 1 . 1 . 1 . 1 . 1 . . . 1 & . . . . . 1 . 1 . 1 . 1 . 1 . . . 1 . 1 . 1 . 1 . 1
0 . 0 . 0 . 1 . 1 . 1 . 1 . 1 . 1 . 1 . 1 . 1 . . . . 1 1 1 1 1 . 1 . 1 . 1 . 1 1 1 . 1 . 1 . 1 . 1
0 . 0 . 0 . 1 . 1 . 1 . 1 . 1 . 1 . 1 . 1 1 1 . . . . 1 . . . 1 . 1 . . . 1 . . . 1 . 1 . 1 . 1 . 1
0 . 0 . 0 . 1 . 1 . 1 . 1 . 1 . 1 . 1 . 1 . . . . . . 1 . 1 . 1 . 1 . 1 . 1 1 1 . 1 . 1 . 1 . 1 . 1
0 . 0 . 0 . 1 . 1 . 1 . 1 . 1 . 1 . 1 . 1 . 1 1 1 1 . 1 . 1 . 1 . 1 . 1 . 1 . . . 1 . 1 . 1 . 1 . 1
0 . 0 . 0 . 1 . 1 . 1 . 1 . 1 . 1 . 1 . 1 . 1 . . . . . . 1 . 1 . . . 1 . 1 . 1 1 1 . 1 . 1 . 1 . 1
0 . 0 . 0 . 1 . 1 . 1 . 1 . 1 . 1 . 1 . 1 1 1 . 1 1 1 1 1 1 . 1 1 1 . 1 . 1 . . . 1 . 1 . 1 . 1 . 1
0 . 0 . 0 . 1 . 1 . 1 . 1 . 1 . 1 . . . 1 . . . . . . . . 1 . . 1 1 . 1 . 1 1 1 . 1 . 1 . 1 . 1 . 1
0 . 0 . 0 . 1 . 1 . 1 . 1 . 1 . 1 1 1 1 1 1 1 1 1 1 1 1 1 1 1 1 1 1 . 1 . 1 . . . 1 . 1 . 1 . 1 . 1
0 . 0 . 0 . 1 . 1 . 1 . 1 . . . . . . . . . . . . . . . . . . . . . . 1 . 1 . 1 1 1 . 1 . 1 . 1 . 1
0 . 0 . 0 . 1 . 1 . 1 . 1 . 1 1 1 1 1 1 . 1 1 1 . 1 1 1 . 1 1 1 . 1 1 1 . 1 . . . . . 1 . 1 . 1 . 1
0 . 0 . 0 . 1 . 1 . 1 . 1 . . . . . 1 . . . 1 . . @c1 . . @c1 . . @c1 . . 1 1 1 . 1 . 1 . 1 . 1 . 1
0 . 0 . 0 . 1 . 1 . 1 . 1 1 1 1 1 . 1 . 1 1 1 1 1 1 1 1 1 1 1 1 1 1 1 1 1 1 . 1 . 1 . 1 . 1 . 1 . 1
0 . 0 . 0 1 1 . 1 1 1 . . . . . . . 1 . . @c1 . . . . . . . . . . . . . . . . 1 . 1 . 1 . 1 . 1 . 1
0 . 0 . 0 . . . 1 . 1 1 1 1 1 1 1 . 1 1 1 1 1 1 1 . 1 1 1 1 1 1 1 1 1 1 1 1 1 1 . 1 . 1 . 1 . 1 . 1
0 . 0 . 0 . 1 1 1 . . . . . . . . . . . . . . . 1 . . . . . . . . . . . . . . . . 1 . 1 . 1 . 1 . 1
0 . 0 . 0 . 1 . 1 1 1 1 1 1 1 1 1 . 1 1 1 1 1 1 1 . 1 1 1 1 1 1 1 1 1 1 1 1 1 1 1 1 . 1 . 1 . 1 . 1
0 . 0 . 0 . 1 . . . . . . . . . . . . . . . . . . . 1 . . . . . . . . . . . . . . . . 1 . 1 . 1 . 1
0 . 0 . 0 . 1 1 1 1 1 1 1 1 1 1 1 . 1 1 1 1 1 1 1 1 1 1 1 1 1 1 1 1 1 1 1 1 1 1 1 1 1 1 . 1 . 1 . 1
0 . 0 . 0 . 1 . . . . . . . . . . . . . . . . . . . . . . . . . . . . . . . . . . . . . . 1 . 1 . 1
0 . 0 . 0 . 1 1 1 1 1 1 1 1 1 1 1 1 1 . 1 . 1 . 1 . 1 . 1 . 1 1 1 1 1 1 1 1 1 1 1 1 1 1 1 1 . 1 . 1
0 . 0 . 0 . . . . . . . . . . . . 1 . . 1 . 1 . . . 1 . 1 . . . . . . . . . . . . . . . . . . 1 . 1
0 . 0 . 0 0 0 0 0 0 0 0 1 1 1 1 1 1 1 1 1 . 1 1 . 1 1 . 1 . 1 1 1 1 1 1 1 1 1 1 1 1 1 1 1 1 1 1 . 1
0 . 0 . . . . . . . . . % 1 @c. . . . . . . . 1 . . 1 . 1 . . . . . . . . . . . . . . . . . . . . 1
0 0 0 0 0 0 0 0 0 0 0 0 1 1 1 1 1 1 1 1 1 1 1 1 1 1 1 1 1 1 1 1 1 1 1 1 1 1 1 1 1 1 1 1 1 1 1 1 1 1
