12,12
1 1 1 1 1 1 1 1 1 1 1 1
1 . . . . . . . . . . 1
1 . . . . . . 1 . . . 1
1 . 1 @d@d. 1 $n1 . . 1
1 . . 1 1 1 . . @c1 . 1
1 . . . . 1 . . 1 1 . 0
0 . . . . . . . . . . .
. . . . . . . . . . . .
. . . 1 . . . . . . . 0
0 . . . . . . . . . . 1
1 . . . . . . @p. . . 1
1 1 0 . . 0 1 1 1 1 1 1