12,12
1 1 1 1 1 1 1 1 1 1 1 1
1 . . . . . . . . . . 1
1 . . . . . . . . . . 1
1 . . . . . . . . . . 1
1 . . 1 1 . . . . . . 1
1 . . 1 1 . 1 . . . . 1
1 . . . . 1 $n1 . . . 1
1 . . . . . . . . . . 1
1 . . . . . . . . . . 1
1 . . . . . . . . . . 1
1 . . . . . @p. . . . 1
1 1 1 1 1 1 1 1 1 1 1 1