12,12
1 1 1 1 1 1 % 1 1 1 1 1
1 . . . . . . . . . . 1
1 . . . . . . . . . . 1
1 . . . . . . . . . . 1
1 . . . . . . . . . . 1
1 . . . . . . . . . . 1
1 . . . . . . @c. . . 1
1 . . . . . . . . . . 1
1 . @c. . . . . . . . 1
1 . . . . . . . . 0 . 1
1 . . . . . & . . 0 @d1
1 1 1 1 1 1 1 1 1 1 1 1
